F +220,100,012
F +220,100,012
C 225,30,0
WE ./Textures/stone-wall.xpm
SO ./Textures/la.xpm
EA ./Textures/aghrab_texture.xpm
NO ./Textures/cat.xpm


111111111111111
111111000111111
111110000011111
1111000S0001111
111000000000111
110000010000011
100001101100001
110000010000011
111000010000111
111100000001111
111110000011111
111111000111111
111111111111111
