F +220,100,0
C 225,30,0

NO ./Textures/aghrab_texture.xpm
SO ./Textures/aghrab_texture.xpm
WE ./Textures/aghrab_texture.xpm
EA ./Textures/aghrab_texture.xpm


1111111111111111111111111
1000000000010000000000001
1011000011000000000000001
1111111110110000011100001
100S011111111111111101111111111111111
1001000000000000000000000000000000001
1011111111111111111111111111111111111
10000001101010110000000000010001
10000000000000000000100011111111
1000000000000000110000001
1100000111011101111110111
1111011111101011011110001
1111111111111111111111111

