C 130,200,229
F 0,128,0
WE ./Textures/WE.xpm
SO ./Textures/SO.xpm
EA ./Textures/EA.xpm
NO ./Textures/NO.xpm


111111111111111
111111000111111
111110000011111
1111000N0001111
111000000000111
110000010000011
100001101100001
110000010000011
111000010000111
111100000001111
111110000011111
111111000111111
111111111111111
