F +220,100,0
C 225,30,0

NO ./Textures/aghrab_texture.xpm
SO ./Textures/aghrab_texture.xpm
WE ./Textures/aghrab_texture.xpm
EA ./Textures/aghrab_texture.xpm


1111111111111111111111111
1000000000110000000000001
1011000001110000000000001
1001000000000000000000001
1111111110110000011100001
1000000000110000011111111
100S001111011100000010001
110001111101110101001000111111
10000001101010110000000000010001
1000000000000000000010001111111
1000000000000000110000001
1100000111010101111110111
1111011111101011011110001
1111111111111111111111111

